########################
#...........#..........#
#.S.........#........C.#
#...........#..........#
#...........#..........#
#......................#
#...........#..........#
#...........#..........#
#...........#..........#
#...........#..........#
######.###########.#####
#...........#..........#
#...........#..........#
#...........#..........#
#...........#..........#
#......................#
#...........#..........#
#.C.........#........G.#
#...........#..........#
########################